when  	WRB
the  	DT
dollar  	NN
advances  	NNS
central  	JJ
bank  	NN
lets  	VBZ
yuan  	JJ
weaken  	NN
against  	IN
it  	PRP
while  	IN
keeping  	VBG
largely  	RB
stable  	JJ
basket  	NN
The  	DT
real  	JJ
test  	NN
will  	MD
come  	VB
for  	IN
China  	NNP
's  	POS
and  	CC
its  	PRP$
exchange-rate  	JJ
policy  	NN
market  	NN
starts  	VBZ
to  	TO
price  	NN
in  	IN
more  	RBR
aggressive  	JJ
Fed  	NNP
rate  	NN
increases  	NNS
resumes  	VBZ
upward  	JJ
march  	NN
which  	WDT
suffered  	VBD
partly  	RB
because  	IN
of  	IN
falling  	VBG
commodity  	NN
prices  	NNS
a  	DT
stronger  	JJR
A  	DT
further  	JJ
decline  	NN
could  	MD
help  	VB
extend  	VB
rebound  	NN
stocks  	NNS
Dollar  	JJ
gains  	NNS
helped  	VBD
push  	VB
down  	RP
Energy  	NNP
led  	VBD
broader  	JJR
higher  	RBR
light  	JJ
holiday  	NN
trading  	NN
last  	JJ
week  	NN
as  	IN
oil  	NN
recovered  	VBD
slightly  	RB
Falling  	VBG
have  	VBP
hurt  	VBN
energy-company  	JJ
results  	NNS
strong  	JJ
has  	VBZ
reduced  	VBN
multinationals  	NNS
'  	POS
profits  	NNS
But  	CC
sharp  	JJ
depreciations  	NNS
emerging-market  	JJ
currencies  	NNS
declines  	NNS
recent  	JJ
weeks  	NNS
triggered  	VBN
an  	DT
exodus  	NN
from  	IN
emerging  	VBG
markets  	NNS
fueled  	VBD
fears  	NNS
among  	IN
investors  	NNS
over  	IN
these  	DT
companies  	NNS
ability  	NN
repay  	VB
their  	PRP$
debt  	NN
materials  	NNS
slumped  	VBN
amid  	IN
downturn  	NN
rising  	VBG
bond  	NN
yields  	NNS
dented  	VBN
high-dividend  	JJ
payers  	NNS
like  	IN
utilities  	NNS
Many  	NNP
forces  	NNS
that  	WDT
hobbled  	VBD
early  	JJ
--  	:
slumping  	VBG
soaring  	VBG
severe  	JJ
winter  	NN
West  	NNP
Coast  	NNP
port  	NN
dispute  	NN
ebbed  	VBN
or  	CC
reversed  	VBN
months  	NNS
Assuming  	VBG
do  	VBP
n't  	RB
make  	VB
another  	DT
move  	NN
S  	NNP
&  	CC
P  	NNP
earnings  	NNS
grow  	VB
by  	IN
%  	NN
this  	DT
year  	NN
fallout  	NN
run-up  	NN
sector  	NN
is  	VBZ
visible  	JJ
shares  	NNS
airlines  	NNS
rose  	VBD
sharply  	RB
second  	JJ
half  	NN
fell  	VBD
surge  	NN
during  	IN
first  	JJ
was  	VBD
economic-stimulus  	JJ
efforts  	NNS
European  	JJ
Central  	NNP
Bank  	NNP
drove  	VBD
eurozone  	RB
lessen  	VB
those  	DT
headwinds  	NNS
well  	RB
contain  	NN
downward  	JJ
pressure  	NN
on  	IN
provide  	VBP
relief  	NN
battered  	JJ
energy  	NN
citing  	VBG
strength  	NN
key  	JJ
factor  	NN
are  	VBP
predicting  	VBG
at  	IN
firms  	NNS
quarter  	NN
show  	VB
biggest  	JJS
annual  	JJ
since  	IN
third  	JJ
due  	JJ
part  	NN
hit  	VBN
lower  	JJR
Money  	NN
managers  	NNS
homing  	VBG
consumer-focused  	JJ
following  	VBG
stands  	VBZ
improve  	VB
U  	NNP
been  	VBN
reason  	NN
strategists  	NNS
say  	VBP
they  	PRP
underestimated  	VBD
potential  	JJ
Shares  	NNS
climbing  	VBG
across  	IN
Asia  	NNP
industrial  	JJ
commodities  	NNS
such  	JJ
copper  	NN
iron  	NN
ore  	RB
bounced  	VBN
back  	RP
signs  	NNS
economy  	NN
revving  	VBG
up  	RP
Investors  	NNS
suffering  	VBG
mounting  	VBG
losses  	NNS
decadelong  	JJ
rise  	NN
unravels  	JJ
slowing  	VBG
emerging-markets  	JJ
economies  	NNS
supplies  	NNS
metals  	NNS
eventual  	JJ
end  	NN
central-bank  	JJ
stimulus  	NN
policies  	NNS
propped  	VBD
raw  	JJ
Outsize  	VB
compared  	VBN
with  	IN
raised  	VBN
some  	DT
questions  	NNS
about  	IN
state  	NN
recovery  	NN
Japanese  	JJ
Monday  	NNP
yen  	NN
weakened  	VBN
continued  	JJ
swift  	NN
mean  	VB
retreat  	NN
dividend-paying  	JJ
decide  	IN
getting  	VBG
better  	JJR
deal  	NN
safe  	JJ
government  	NN
Romney  	NNP
betting  	VBG
gold  	NN
There  	EX
softness  	NN
demand  	NN
cut  	VB
into  	IN
U.  	NNP
fund  	NN
positioned  	VBN
Asian  	JJ
high-quality  	JJ
fear  	VBP
high  	JJ
inflation  	NN
other  	JJ
may  	MD
quash  	VB
nascent  	JJ
weigh  	NN
ticking  	VBG
many  	JJ
saw  	VBD
them  	PRP
proxies  	NNS
economic  	JJ
auto  	NN
maker  	NN
reported  	VBD
costs  	NNS
steel  	NN
drag  	VB
fourth-quarter  	JJ
profit  	NN
meaning  	VBG
almost  	RB
always  	RB
were  	VBD
mostly  	RB
what  	WP
rally  	RB
despite  	IN
spreading  	VBG
political  	JJ
turmoil  	NN
Middle  	NNP
East  	NNP
sustained  	VBD
misery  	NN
also  	RB
suggest  	VBP
expectations  	NNS
``  	``
We  	PRP
here  	RB
categorically  	RB
nothing  	NN
whatsoever  	NN
equities  	NNS
boost  	VB
lift  	JJ
sparked  	VBD
pattern  	JJ
had  	VBD
rely  	VB
Prices  	NNS
precious  	JJ
metal  	NN
all-time  	JJ
highs  	NNS
both  	DT
gasoline  	NN
started  	VBD
July  	NNP
stock  	NN
celebrated  	VBD
hopes  	NNS
would  	MD
consumer  	NN
spending  	NN
speed  	NN
drop  	NN
fueling  	VBG
It  	PRP
holds  	VBZ
large  	JJ
amounts  	NNS
hedges  	NNS
sending  	VBG
flying  	VBG
Giving  	VBG
Stocks  	VBZ
Lift  	NNP
-  	:
Verizon  	NN
Vodafone  	NNP
Jump  	NNP
Deal  	NNP
News  	NNP
As  	IN
Oil  	NNP
Rise  	NNP
futures  	NNS
retreated  	VBD
record  	NN
around  	IN
$  	$
barrel  	NN
relatively  	RB
benign  	JJ
data  	NNS
price-sensitive  	JJ
retailers  	NNS
Macy  	NNP
Range  	NNP
Resources  	NNPS
plunged  	VBD
Wednesday  	NNP
Dow  	NNP
Jones  	NNP
Industrial  	NNP
Average  	NNP
recorded  	VBD
two-session  	NN
February  	NNP
after  	IN
Federal  	NNP
Reserve  	NNP
warned  	VBD
concern  	NN
likely  	RB
preclude  	VB
interest-rate  	JJ
closed  	VBN
above  	IN
pessimism  	NN
pared  	VBN
driven  	VBN
Airline  	VBP
weighed  	VBD
gain  	NN
With  	IN
bought  	VBD
free  	JJ
fall  	NN
levels  	NNS
long  	JJ
overseas  	JJ
toward  	IN
values  	NNS
similar  	JJ
Despite  	IN
declining  	VBG
several  	JJ
airline  	NN
Friday  	NNP
impact  	NN
flight  	NN
cancellations  	NNS
spot  	NN
safety  	NN
checks  	NNS
deflated  	VBD
silver  	NN
all  	DT
only  	JJ
areas  	NNS
momentum  	NN
financial  	JJ
but  	CC
ounce  	NN
reacted  	VBN
positively  	RB
theory  	NN
International  	NNP
Business  	NNP
Machines  	NNPS
revived  	VBD
soften  	VB
blow  	NN
domestic  	JJ
slowdown  	NN
big  	JJ
tech  	NN
He  	PRP
take  	VB
advantage  	NN
protect  	JJ
clients  	NNS
weakening  	NN
tend  	VBP
recession  	NN
cooled  	VBN
waffled  	VBD
weakness  	NN
transportation  	NN
Last  	JJ
slide  	NN
began  	VBD
Tuesday  	NNP
close  	RB
three-year  	JJ
low  	NN
news  	NN
trade  	NN
deficit  	NN
Japan  	NNP
refusal  	NN
ease  	VB
monetary  	JJ
Financial  	NNP
issues  	NNS
most  	JJS
sensitive  	JJ
stimulated  	VBN
adds  	VBZ
accompanying  	VBG
advance  	NN
Bond  	NN
advanced  	VBD
mixed  	JJ
signals  	NNS
provided  	VBN
reports  	NNS
eventually  	RB
followed  	VBD
suit  	NN
rebounding  	VBG
mid-session  	NN
lows  	NNS
turning  	VBG
final  	JJ
hour  	NN
achieved  	VBN
moderate  	JJ
victim  	NN
renewed  	VB
corresponding  	JJ
slump  	NN
bonds  	NNS
took  	VBD
off  	RP
midsession  	NN
sudden  	JJ
posted  	VBD
sharpest  	JJS
than  	IN
bolstered  	VBN
report  	NN
sign  	NN
not  	RB
tighten  	VB
credit  	NN
Higher  	JJR
selected  	JJ
contributed  	VBD
said  	VBD
summer  	NN
stalled  	VBD
failed  	VBD
attract  	VB
foreign  	JJ
investment  	NN
people  	NNS
hoped  	VBN
Some  	DT
traders  	NNS
attributed  	VBD
afternoon  	NN
Plunge  	NNP
Gains  	NNP
Industrials  	NNS
Drop  	NNP
past  	JJ
days  	NNS
clear  	JJ
risk  	NN
out  	RP
there  	RB
Traders  	NNS
30-year  	JJ
Treasury  	NNP
tobacco  	NN
stabilize  	VB
yesterday  	NN
An  	DT
unexpectedly  	RB
CPI  	NNP
easily  	RB
knock  	VB
upturn  	NN
climb  	NN
ended  	VBD
generally  	RB
unexpected  	JJ
steep  	JJ
gave  	VBD
additional  	JJ
share  	NN
sagged  	VBN
January  	NNP
firming  	VBG
remained  	VBD
company  	NN
natural  	JJ
gas  	NN
reserves  	NNS
again  	RB
pause  	NN
August  	NNP
September  	NNP
reflecting  	VBG
beyond  	IN
upper  	JJ
limit  	NN
range  	NN
opening  	NN
sell  	NN
programs  	NNS
tied  	VBD
stock-index  	NN
arbitrage  	NN
pulled  	VBD
NEW  	JJ
YORK  	NNP
Although  	IN
rebounded  	VBD
sell-off  	NN
reversal  	NN
necessary  	JJ
before  	IN
next  	JJ
presidential  	JJ
election  	NN
Part  	NN
Stock  	NNP
late  	JJ
bargain-hunting  	NN
blunted  	VBD
evidence  	NN
interest  	NN
rates  	NNS
jump  	NN
curbed  	VBD
enthusiasm  	NN
initially  	RB
morning  	NN
soared  	VBD
weekend  	NN
decision  	NN
Organization  	NNP
Petroleum  	NNP
Exporting  	NNP
Countries  	NNPS
renew  	VB
seek  	VB
cooperation  	NN
nonmember  	JJ
producers  	NNS
moved  	VBD
response  	NN
change  	NN
direction  	NN
coincided  	VBD
tumbled  	VBD
growing  	VBG
stalling  	NN
disappearing  	VBG
dramatic  	JJ
crude  	JJ
major  	JJ
reductions  	NNS
then  	RB
plunge  	NN
latch  	VB
new  	JJ
concept  	NN
''  	''
continue  	VB
along  	IN
ride  	NN
put  	VBD
damper  	NN
shrugged  	VBD
poor  	JJ
reading  	NN
instead  	RB
focused  	VBD
Another  	DT
cited  	VBD
bedrock  	NN
surprising  	JJ
caused  	VBD
average  	NN
skid  	VB
points  	NNS
bell  	NN
session  	NN
powerful  	JJ
'Blue-Chip  	JJ
Close  	NNP
Down  	NNP
On  	IN
Session-Long  	JJ
Weakness  	NNP
analysts  	NNS
view  	VBP
period  	NN
1960s  	NNS
through  	IN
extended  	JJ
shot  	VBD
buying  	VBG
short-term  	JJ
looking  	VBG
quick  	JJ
Lower  	JJR
precious-metals  	NNS
slight  	JJ
disappointment  	NN
did  	VBD
caught  	VBD
abrupt  	JJ
midday  	NN
selling  	NN
Peroni  	NNP
believes  	VBZ
portend  	VB
somewhat  	RB
ahead  	RB
looked  	VBD
attractive  	JJ
goes  	VBZ
tailspin  	NN
fundamental  	JJ
skyrocket.  	VBP
he  	PRP
maintains  	VBZ
any  	DT
be  	VB
accompanied  	VBN
shortly  	RB
jittery  	JJ
technology  	NN
That  	IN
face  	NN
betrays  	VBZ
underlying  	JJ
desire  	NN
still  	RB
Burnett  	NNP
noted  	VBD
today  	NN
added  	VBD
bonds.  	VB
expects  	VBZ
few  	JJ
stage  	VB
concurrent  	JJ
Firmer  	JJR
And  	CC
Are  	NNP
Factors  	NNP
offset  	VB
soft  	JJ
sales  	NNS
Wal-Mart  	NNP
Stores  	NNPS
We\  	NNP
've  	VBP
got  	VBN
moving  	VBG
building  	NN
bit  	NN
delayed  	JJ
reaction  	NN
midafternoon  	NN
release  	NN
minutes  	NNS
Reserve\  	NNP
meeting  	NN
turned  	VBD
earlier  	RBR
until  	IN
Slide  	NNP
Could  	NNP
Roil  	NNP
Importer  	NN
Might  	NNP
Take  	NNP
Hit  	NNP
Slower  	NNP
Foreign  	NNP
Demand  	NNP
May  	NNP
Put  	NNP
Dent  	NNP
Too  	NNP
bad  	JJ
can  	MD
lead  	VB
`  	``
Is  	VBZ
10-year  	JJ
going  	VBG
follow  	VB
?  	.
\  	NNP
Crude  	NNP
growth  	NN
bullish  	JJ
willing  	JJ
accept  	VB
greater  	JJR
volatility  	NN
rather  	RB
sticking  	VBG
tried-and-true  	JJ
belief  	NN
receive  	VB
returns  	NNS
beating  	VBG
disappointing  	JJ
General  	NNP
Electric  	NNP
Advanced  	NNP
Micro  	NNP
Devices  	NNPS
closing  	NN
result  	NN
favorable  	JJ
consumer-price  	JJ
index  	NN
propel  	VB
Wall  	NNP
Street  	NNP
given  	VBN
gift  	NN
faded  	VBD
progressed  	VBD
FedEx  	NNP
second-quarter  	JJ
boosted  	VBD
outlook  	NN
lifting  	VBG
wind  	NN
sails  	NNS
Gold  	NN
usually  	RB
something  	NN
thinks  	VBZ
head  	VB
keep  	VB
hurting  	VBG
knocking  	VBG
blue-chip  	NN
increase  	VB
helping  	VBG
squelch  	JJ
inflationary  	JJ
pressures  	NNS
pushed  	VBN
reliable  	JJ
dividend  	NN
used  	VBN
substitute  	NN
income-seeking  	JJ
amount  	NN
income  	NN
produce  	VBP
per  	IN
invested  	VBN
Utility  	NN
love  	NN
traded  	VBD
Rate  	NNP
Increases  	VBZ
Mar  	NNP
Once-Bright  	NNP
Hopes  	NNP
Surge  	NNP
top  	NN
showing  	VBG
durable-goods  	JJ
orders  	NNS
economically  	RB
Dow-industrial  	JJ
component  	NN
Caterpillar  	NNP
late-session  	JJ
selloff  	NN
Merck  	NNP
trimmed  	VBD
early-session  	JJ
Optimistic  	JJ
believe  	VBP
corporate  	JJ
so  	RB
permit  	VB
worries  	NNS
seasonal  	JJ
Home  	NNP
Depot  	NNP
Pace  	NNP
Blue  	NNP
Chips  	NNP
Soar  	VBP
Declines  	NNP
finished  	VBD
although  	IN
aftermath  	NN
Hurricane  	NNP
Katrina  	NNP
American  	NNP
Airlines  	NNP
parent  	NN
AMR  	NNP
Humana  	NNP
Record  	NNP
End  	NNP
Session  	NNP
Mixed  	NNP
Hits  	NNP
High  	NNP
without  	IN
break  	NN
April  	NNP
vulnerable  	JJ
pullback  	NN
announcement  	NN
letting  	VBG
currency  	NN
float  	NN
sent  	VBD
shock  	NN
below  	IN
time  	NN
month  	NN
Protein  	NNP
Design  	NNP
Labs  	NNP
Gain  	NNP
Aided  	NNP
By  	IN
Decline  	NNP
In  	IN
hold  	VB
robust  	JJ
confidence  	NN
held  	VBD
own  	JJ
fresh  	JJ
outlooks  	NNS
Nike  	NNP
together  	RB
terrorism  	NN
withstood  	VBD
attention  	NN
positive  	JJ
Genentech  	NNP
actually  	RB
Thursday  	NNP
featured  	VBD
acquisition-related  	JJ
activity  	NN
involving  	VBG
PacifiCare  	NNP
Health  	NNP
Systems  	NNPS
series  	NN
serious  	JJ
trouble  	NN
world  	NN
tensions  	NNS
years  	NNS
specter  	NN
combined  	VBD
caution  	NN
Cisco  	NNP
concerns  	NNS
Group  	NNP
scurrying  	VBG
sidelines  	NNS
Boeing  	NNP
Help  	NNP
Climb  	NNP
Major  	JJ
Indexes  	NNS
Post  	NNP
Price  	NNP
course  	NN
hitting  	VBG
intraday  	NN
Price-Earnings  	NNS
Ratio  	NNP
Expected  	NNP
Yields  	NNP
focus  	NN
away  	RB
Strength  	NN
recover  	VB
four-month  	JJ
quashed  	VBD
encouraging  	VBG
comments  	NNS
Chairman  	NNP
Alan  	NNP
Greenspan  	NNP
Walt  	NNP
Disney  	NNP
attention-getters  	NNS
day  	NN
Most  	JJS
economists  	NNS
who  	WP
predict  	VBP
assume  	VB
GDP  	NNP
weaker  	JJR
give  	VB
very  	RB
much  	RB
encouraged  	VBN
strengthened  	JJ
get  	VB
October  	NNP
peaked  	VBD
join  	VB
depends  	VBZ
idea  	NN
think  	VBP
underestimating  	VBG
{  	(
}  	)
general  	JJ
worked  	VBD
way  	NN
rallied  	VBD
one-point  	JJ
official  	JJ
discount  	NN
cue  	NN
dropping  	VBG
straight  	JJ
tracking  	VBG
tumbling  	VBG
surged  	VBD
rapid  	JJ
main  	JJ
feel  	VBP
November  	NNP
played  	VBN
crucial  	JJ
role  	NN
impressive  	JJ
set  	VB
table  	NN
engine  	NN
driving  	VBG
thrust  	NN
long-term  	JJ
worried  	JJ
sold  	VBD
host  	NN
see  	VB
margins  	NNS
contract  	NN
if  	IN
swept  	VBD
even  	RB
though  	IN
reached  	VBN
18-month  	JJ
Yesterday  	NN
came  	VBD
Manuel  	NNP
Johnson  	NNP
does  	VBZ
expect  	VB
return  	VB
prevailed  	VBD
explosive  	JJ
Consumer  	NN
hard  	RB
heightened  	VBD
oil-field  	JJ
services  	NNS
Rebounds  	NNPS
drug  	NN
drive  	VB
December  	NNP
support  	NN
narrowly  	RB
dominated  	VBN
glumness  	NN
insider-trading  	JJ
scandal  	NN
nervousness  	NN
approach  	NN
Friday\  	NNP
triple  	JJ
witching  	VBG
expirations  	NNS
lent  	VBD
overall  	JJ
measures  	NNS
Selected  	VBN
Persian  	NNP
Gulf  	NNP
situation  	NN
headed  	VBD
gained  	VBD
level  	NN
ago  	RB
broke  	VBD
31-a-barrel  	JJ
mark  	NN
latest  	JJS
officials  	NNS
how  	WRB
appeared  	VBD
precious-metal  	JJ
conjure  	VB
burst  	VB
onto  	IN
scene  	NN
Market  	NNP
Puzzling  	VBG
Buyers  	NNP
Large  	NNP
Small  	NNP
Keep  	NNP
Pouring  	NNP
Bear  	NNP
Cites  	NNP
Plunging  	NNP
profit-taking  	NN
continuing  	VBG
optimism  	NN
improvement  	NN
Tokyo  	NNP
London  	NNP
surprised  	JJ
didn\'t  	JJ
consecutive  	JJ
go  	VB
Arco  	NNP
recommendation  	NN
board  	NN
notable  	JJ
exception  	NN
oil-related  	JJ
contended  	VBD
spilled  	VBD
fact  	NN
focusing  	VBG
it\  	NN
less  	JJR
problem  	NN
watchers  	NNS
feared  	VBD
reluctant  	JJ
anytime  	RB
soon  	RB
appears  	VBZ
related  	VBN
pickup  	NN
pace  	NN
lofty  	JJ
indexes  	NNS
left  	VBN
enough  	RB
withdraw  	VB
sight  	NN
Transportation  	NN
fuel  	VB
later  	RBR
near  	JJ
Commodity  	NNP
Research  	NNP
Bureau  	NNP
settled  	VBD
tight  	JJ
active  	JJ
spurred  	VBN
Thrusting  	VBG
need  	NN
diversify  	VB
riches  	NNS
generated  	VBN
savings  	NNS
surplus  	NN
climbed  	VBD
showed  	VBD
inventories  	NNS
increasing  	VBG
wore  	NN
flat  	JJ
firmer  	JJR
repeated  	VBD
injections  	NNS
funds  	NNS
banking  	NN
system  	NN
Precious-metal  	JJ
five-year  	JJ
'Stocks  	NNS
Regain  	VBP
Lost  	NNP
Ground  	NNP
Rebound  	NNP
reasons  	NNS
punishment  	NN
fastgrowing  	VBG
enduring  	VBG
being  	VBG
dealt  	VBN
sparking  	VBG
solid  	JJ
restrained  	VBD
gross-domestic-product  	NN
Also  	RB
often  	RB
lose  	VB
oil-producing  	JJ
nations  	NNS
substantial  	JJ
heating  	NN
indications  	NNS
OPEC  	NNP
production  	NN
restraint  	NN
reflected  	VBN
lethargic  	JJ
utility  	NN
prior  	RB
yesterday\  	VB
across-the-board  	JJ
Should  	MD
raise  	VB
cash  	NN
Was  	VBD
wise  	VBZ
switch  	VB
Chevron  	NNP
lost  	VBD
British  	JJ
pound  	NN
skeptical  	JJ
bid  	NN
group  	NN
Sir  	NNP
James  	NNP
Goldsmith  	NNP
taking  	VBG
lowest  	JJS
backed  	VBD
shaken  	VBN
throttled  	VBD
follow-up  	JJ
Oops  	UH
!  	.
Points  	NNS
Sharp  	NNP
Turnabout  	NNP
Hectic  	JJ
Late  	JJ
Trading  	NN
Erases  	NNP
New  	NNP
Set  	NNP
Effect  	NNP
'Sell  	NNP
Programs  	NNP
Triggers  	NNP
apparently  	RB
Why  	WRB
She  	PRP
she  	PRP
suspects  	VBZ
waiting  	VBG
look  	VB
placed  	VBD
firm  	JJ
bets  	NNS
ticked  	VBD
crude-oil  	NN
escalating  	VBG
More  	JJR
puzzling  	NN
blithely  	RB
hunkered  	VBN
fret  	VBP
unless  	IN
current  	JJ
rapidly  	RB
unravel  	VB
path  	NN
beginning  	NN
resulting  	JJ
console  	VB
unable  	JJ
developed  	VBN
planned  	VBD
capacity  	NN
whatever  	WDT
military  	JJ
action  	NN
place  	NN
number  	NN
money  	NN
violence  	NN
disrupt  	VB
flow  	NN
field-services  	JJ
others  	NNS
question  	VBP
Further  	JJ
fortified  	VBD
allowing  	VBG
post  	VB
sprightly  	RB
participate  	VB
Several  	JJ
anticipation  	NN
inventory  	NN
natural-gas  	JJ
paper  	NN
forest-products  	NNS
wood-product  	NN
you  	PRP
prospects  	NNS
peace  	NN
settlement  	NN
eased  	VBD
threats  	NNS
preceding  	VBG
indicated  	VBD
starting  	VBG
kick  	VB
Even  	RB
staged  	VBD
inasmuch  	JJ
might  	MD
suggested  	VBN
should  	MD
dim  	VB
supply-demand  	JJ
considerations  	NNS
Merger  	NN
talk  	NN
entertainment  	NN
source  	NN
names  	NNS
wake  	NN
sinking  	VBG
under  	IN
weight  	NN
sympathy  	NN
wouldn\'t  	NN
keen  	JJ
gold-company  	JJ
combination  	NN
blue  	JJ
chips  	NNS
Saudi  	NNP
Paper  	NNP
notched  	VBD
modest  	JJ
critical  	JJ
survey  	NN
expected  	VBD
unnerving  	VBG
whether  	IN
inspired  	VBD
already  	RB
Phelps  	NNP
Dodge  	NNP
Freeport-McMoran  	NNP
Copper  	NNP
pushing  	VBG
allow  	VB
I  	PRP
want  	VBP
shift  	VB
my  	PRP$
Rising  	VBG
Advance  	NNP
Steep  	NNP
imply  	VB
Japan\  	NNP
deserve  	VB
P/E  	NNP
ratios  	NNS
Blue-chip  	JJ
modestly  	RB
manufacturing  	NN
aggressiveness  	NN
High-technology  	JJ
overcame  	VBP
worry  	VBP
industry  	NN
notch  	VB
patch  	NN
tentative  	JJ
statements  	NNS
energy-services  	NNS
field-service  	NN
pricing  	NN
products  	NNS
loss  	NN
anticipated  	JJ
doldrums  	NNS
Banking  	VBG
consolidation  	NN
silver-mining  	JJ
investor  	NN
Warren  	NNP
Buffett  	NNP
knocked  	VBN
oil-services  	NNS
unemployment  	NN
fleeing  	VBG
phenomenon  	NN
tracked  	VBD
remains  	VBZ
check  	NN
violent  	JJ
managed  	VBD
muted  	JJ
buffeted  	VBN
Thanks  	NNS
smaller  	JJR
broad  	JJ
primed  	VBN
meltdown  	NN
second-biggest  	JJ
single-day  	JJ
Exxon  	NNP
late-day  	JJ
program  	NN
actively  	RB
York  	NNP
Exchange  	NNP
history  	NN
underpinned  	VBD
propelling  	VBG
setting  	VBG
tone  	NN
surging  	VBG
especially  	RB
stronger-than-expected  	JJ
fourth  	JJ
analyst  	NN
pay  	VB
price/earnings  	NNS
multiple  	NN
chemical  	JJ
ample  	JJ
probably  	RB
'Industrials  	NNS
Quiet  	NNP
Companies  	NNP
opened  	VBD
greatest  	JJS
exposure  	NN
enjoyed  	VBD
strongest  	JJS
Caution  	NNP
highly  	RB
employment  	NN
outweighed  	VBD
Recent  	JJ
uncertainty  	NN
Iraq  	NNP
Reaction  	NNP
Give  	NNP
Up  	NNP
University  	NNP
Michigan  	NNP
weak  	JJ
edged  	VBD
bigger  	JJR
accounted  	VBD
portion  	NN
Other  	JJ
stoked  	VBD
briefly  	VBP
lifted  	VBD
within  	IN
hair  	NN
finish  	NN
regional  	JJ
once  	RB
budget  	NN
drew  	VBD
Rally  	NNP
Spur  	NNP
To  	TO
Loss  	NNP
one-third  	NN
trim  	VB
Warning  	VBG
You\  	NNP
'd  	MD
hate  	VB
call  	NN
correct  	NN
performance  	NN
neutralized  	VBN
market\  	NN
suggests  	VBZ
While  	IN
tame  	JJ
bidding  	NN
mustered  	VBD
problems  	NNS
poses  	NNS
abroad  	RB
joined  	VBD
broad-based  	JJ
referendum  	NN
kept  	VBN
dragged  	VBD
addition  	NN
hard-pressed  	JJ
ignore  	VB
continues  	VBZ
flood  	VB
stabilizes  	VBD
rises  	NNS
permanently  	RB
Analysts  	NNS
unsettled  	VBD
received  	VBD
eroded  	VBD
first-quarter  	JJ
robbed  	VBD
forward  	NN
resurgent  	JJ
bond-market  	NN
solidly  	RB
depreciating  	NN
built-in  	JJ
operations  	NNS
chased  	VBD
reassuring  	JJ
Interest-rate  	NNP
whose  	WP$
behind  	IN
year-end  	JJ
important  	JJ
strongly  	RB
undermining  	JJ
tax-cut-driven  	JJ
remain  	VBP
concerned  	JJ
steady  	JJ
prospect  	NN
tightening  	VBG
snapped  	VBD
sessions  	NNS
finally  	RB
downdraft  	NN
post-World  	JJ
War  	NNP
II  	NNP
two-year  	JJ
skidded  	VBD
tumble  	JJ
encourage  	VB
Troubling  	VBG
worst  	JJS
fourth-straight  	JJ
producer  	NN
cleared  	VBD
declined  	VBD
nervous  	JJ
rumors  	NNS
liquidations  	NNS
mortgage-backed  	JJ
securities  	NNS
shove  	VB
full  	JJ
point  	NN
Mostly  	NNP
Low  	NNP
Precious-metals  	NNS
dispelled  	VBD
widely  	RB
resumed  	VBD
Uncertainty  	NN
highest  	JJS
erode  	VB
reduces  	VBZ
value  	NN
foreigners  	NNS
investments  	NNS
dollardenominated  	JJ
Surprisingly  	RB
rout  	NN
inaction  	NN
effort  	NN
control  	VB
Dazed  	NNP
confused  	VBD
leaving  	VBG
mirrored  	VBN
movement  	NN
throughout  	IN
certainly  	RB
pummel  	VB
badly  	RB
unconvinced  	JJ
settling  	VBG
Tumbling  	VBG
depressed  	VBD
futures-related  	JJ
When  	WRB
plummeted  	VBD
mounted  	VBD
carried  	VBD
crept  	VBD
watched  	VBD
including  	VBG
snapback  	NN
beleaguered  	JJ
underwent  	VBD
phenomenal  	JJ
providing  	VBG
foundation  	NN
handful  	NN
propelled  	VBD
Sharply  	NNP
made  	VBN
fairly  	RB
quiet  	JJ
interest-rate-sensitive  	JJ
equity  	NN
Canelo  	NNP
doesn\'t  	VBZ
derailed  	VBD
Continued  	JJ
preyed  	VBD
upon  	IN
powered  	VBD
yield  	NN
petered  	VBD
leave  	VB
ceiling  	NN
untouched  	JJ
surprise  	NN
huge  	JJ
England  	NNP
base  	NN
Slumping  	VBG
tempered  	VBD
spirits  	NNS
leading  	VBG
ultimately  	RB
rattled  	VBD
Equities  	NNS
3/4-point  	JJ
Disappointing  	VBG
ignored  	VBD
health-care  	JJ
supported  	VBN
buoyed  	VBN
bill  	NN
defeated  	VBN
Turmoil  	NNP
Boost  	NNP
Erase  	NNP
All  	NNP
effectively  	RB
wiping  	VBG
equal  	JJ
If  	IN
professionals  	NNS
thus  	RB
capturing  	VBG
eat  	VB
forced  	VBD
sink  	VB
contracts  	NNS
grain  	NN
previous  	JJ
periods  	NNS
mutual  	JJ
turn  	VB
sour  	NN
switched  	VBD
inched  	VBD
soothed  	VBD
jitters  	NNS
negative  	JJ
Retreat  	NNP
Worries  	VBZ
Surging  	VBG
hope  	VBP
federal  	JJ
changes  	NNS
Precious  	JJ
Dudack  	NNP
emotional  	JJ
easing  	NN
skirmishing  	NN
Russia  	NNP
depress  	VB
accelerating  	VBG
Supplies  	NNS
disrupted  	VBN
drastically  	RB
putting  	VBG
pull  	VB
pour  	VBP
Eastman  	NNP
Kodak  	NNP
mask  	VB
increased  	VBD
McAlinden  	NNP
reignite  	VB
restrain  	VB
Fall  	VBP
Prospect  	NNP
Leap  	NNP
sluggish  	JJ
That\  	NNP
bounce  	VB
spite  	NN
means  	VBZ
groups  	NNS
compares  	VBZ
cyclical  	JJ
seemingly  	RB
ignoring  	VBG
Commerce  	NNP
Department  	NNP
durable  	JJ
goods  	NNS
significantly  	RB
tried  	VBD
catch  	VB
rip-roaring  	JJ
encourages  	VBZ
seen  	VBN
peaks  	NNS
Abrams  	NNP
argues  	VBZ
discounted  	VBN
wo  	MD
pack  	VB
nearly  	RB
punch  	NN
drops  	NNS
buoyant  	JJ
mood  	NN
middle  	NN
fade  	VB
Renewed  	VBD
skepticism  	NN
celebration  	NN
stability  	NN
ground  	NN
mildly  	RB
prompted  	VBD
edging  	VBG
Brokerage  	JJ
reduction  	NN
offerings  	NNS
gathered  	VBD
steam  	NN
firmed  	VBD
Board  	NNP
Share  	NN
proved  	VBD
contagious  	JJ
sobering  	JJ
surprisingly  	RB
seems  	VBZ
sputtering  	VBG
aided  	VBD
computer-guided  	JJ
buy  	NN
recently  	RB
rocketing  	VBG
speculation  	NN
size  	NN
Colombian  	JJ
field  	NN
'The  	CC
Profits  	NNP
Drag  	NNP
Firming  	VBG
oversold  	JJ
brief  	JJ
meant  	VBD
computer-driven  	JJ
Then  	RB
spark  	VB
brought  	VBD
went  	VBD
Following  	VBG
pre-holiday  	JJ
prompt  	VB
blamed  	VBN
lackluster  	JJ
steepest  	JJS
reacting  	VBG
deep  	JJ
created  	VBD
continually  	RB
improving  	VBG
environment  	NN
far  	RB
become  	VB
competitive  	JJ
where  	WRB
contribution  	NN
bottom  	JJ
line  	NN
presence  	NN
eliminate  	VB
least  	JJS
seriously  	RB
reduce  	VB
anticipate  	VBP
stall  	VB
Mideast  	NNP
Peace  	NNP
material  	NN
slid  	VBD
Brisk  	NNP
Volume  	NN
one-two  	JJ
plunging  	VBG
daily  	RB
volatile  	JJ
stumbled  	VBD
midmorning  	NN
apparent  	JJ
stem  	VB
surrounding  	VBG
responding  	VBG
daylong  	JJ
edge  	VB
upswing  	NN
rekindled  	VBN
President  	NNP
Bush  	NNP
resolve  	NN
Declining  	VBG
routed  	VBD
advancers  	NNS
dominating  	VBG
list  	NN
gainers  	NNS
Growth  	NN
recession-resistant  	JJ
paced  	VBD
bucked  	VBD
Iraqi  	NNP
troops  	NNS
invaded  	VBD
Kuwait  	NNP
words  	NNS
Pan  	NNP
Am  	VBP
plans  	VBZ
fare  	JJ
jet  	NN
target  	NN
weekin  	JJ
waves  	NNS
kind  	NN
heck  	NN
bull-market  	JJ
historical  	JJ
premium  	NN
restored  	VBN
pushes  	VBZ
sharper  	JJ
adjustment  	NN
Arabia\  	NNP
discounts  	NNS
purchase  	NN
causing  	VBG
build  	VB
jobs  	NNS
chief  	JJ
really  	RB
contend  	VBP
faltered  	VBN
affected  	VBD
confirmed  	VBD
considering  	VBG
urgent  	JJ
options  	NNS
stop  	VB
abruptly  	RB
emergency  	NN
address  	VB
Amid  	NNP
Sell-Off  	NNP
subsequent  	JJ
initial  	JJ
catalyst  	NN
telephone  	NN
him  	PRP
slipped  	VBD
competed  	VBD
dollars  	NNS
broadly  	RB
rounds  	NNS
South  	JJ
African  	JJ
rand  	NN
overnight  	VBD
petroleum  	NN
pacing  	VBG
Bargain-hunting  	NN
underpin  	JJ
tripped  	VBD
Program  	NNP
kicked  	VBD
cheaper  	JJR
involved  	VBN
actual  	JJ
rumored  	VBN
takeover  	NN
bids  	NNS
junk  	NN
round  	NN
expiration  	NN
institutions  	NNS
heavy  	JJ
banks  	NNS
prime  	JJ
lending  	NN
business  	NN
start-up  	JJ
Spain  	NNP
France  	NNP
largest  	JJS
reassessed  	VBD
multinational  	JJ
corporations  	NNS
Drug  	JJ
Pfizer  	NNP
forecast  	NN
net  	JJ
Just  	RB
(  	(
Amex  	NNP
)  	)
cross  	VB
today\  	NN
Solid  	NNP
British-based  	JJ
Britain  	NNP
early-morning  	JJ
10-an-ounce  	JJ
Hecla  	NNP
Mining  	NNP
Battle  	NNP
Mountain  	NNP
'Selling  	VBG
Technology  	NNP
Issues  	NNP
Sends  	NNP
rallying  	VBG
assist  	NN
computer-assisted  	JJ
drawing  	VBG
best  	JJS
riding  	VBG
totally  	RB
drifted  	VBD
After  	IN
congressional  	JJ
testimony  	NN
fighting  	VBG
latched  	VBN
benefited  	VBD
digests  	VBZ
start  	VB
continuation  	NN
temptingly  	RB
sense  	NN
responded  	VBD
Supported  	VBN
Yet  	CC
rolling  	VBG
Chicago  	NNP
Trade  	NNP
tail  	JJ
small  	JJ
soar  	VBP
typically  	RB
themselves  	PRP
buyers  	NNS
attempt  	VB
oil-price  	JJ
pointed  	VBD
President-elect  	NNP
Bush\  	NNP
agreement  	NN
expectation  	NN
fought  	VBD
giving  	VBG
Without  	IN
turnaround  	NN
choppy  	JJ
coupled  	VBD
At  	IN
root  	NN
stock-market  	JJ
cause  	VB
numbers  	NNS
GNP  	NNP
released  	VBN
moves  	NNS
bout  	NN
exacerbated  	VBN
incentive  	NN
Improvement  	NN
Profit-taking  	NN
skittishness  	NN
closely  	RB
mild  	JJ
nose  	VBD
slowest  	JJS
generate  	VB
same  	JJ
type  	NN
accelerate  	VB
sees  	VBZ
lining  	NN
stock-price  	JJ
calls  	VBZ
private  	JJ
possibility  	NN
heading  	VBG
translated  	VBD
gold-mining  	JJ
Iran  	NNP
acceptance  	NN
United  	NNP
Nations  	NNPS
resolution  	NN
calling  	VBG
cease-fire  	NN
war  	NN
felt  	VBD
form  	NN
either  	CC
persistent  	JJ
relieved  	VBD
slow  	JJ
moderately  	RB
says  	VBZ
industrials  	NNS
short  	NN
sends  	VBZ
post-crash  	JJ
Goldman  	NNP
failure  	NN
CRB  	NNP
signaling  	VBG
dangers  	NNS
asserted  	VBD
world-wide  	JJ
greeted  	VBD
compete  	VB
benefit  	VBP
seemed  	VBD
fight  	NN
explosion  	NN
Shell  	NNP
refining  	NN
plant  	NN
Louisiana  	NNP
bluechip  	NN
agree  	VB
plan  	NN
cutting  	VBG
output  	NN
impressed  	JJ
hurdle  	NN
find  	VB
leap  	VB
clearly  	RB
position  	NN
snap  	VBD
Stronger  	NNP
Overseas  	NNP
jumped  	VBD
note  	NN
exacerbating  	VBG
implications  	NNS
economy\  	NN
isn\'t  	VBZ
lot  	NN
send  	VB
70-cent-a-barrel  	JJ
Sharma  	NNP
events  	NNS
trigger  	VB
evident  	JJ
larger-than-expected  	JJ
merchandise  	NN
Cautious  	JJ
roused  	VBN
retail-sales  	JJ
dragging  	VBG
outset  	NN
roughly  	RB
relentless  	NN
overcome  	VB
tax  	NN
Bureau\  	NNP
convince  	VB
overstated  	VBN
Anxiety  	NN
wave  	NN
retailing  	VBG
cases  	NNS
third-quarter  	JJ
argue  	VBP
peak  	NN
crash  	NN
now  	RB
hoping  	VBG
These  	DT
bills  	NNS
sounder  	NN
footing  	NN
skyrocket  	NN
late-afternoon  	JJ
healthy  	JJ
Newmont  	NNP
Delaware  	NNP
court  	NN
judge  	NN
ordered  	VBD
Consolidated  	NNP
Fields  	NNP
PLC  	NNP
separate  	JJ
hearing  	NN
approximately  	RB
holding  	VBG
direct  	JJ
energy-related  	JJ
mining  	NN
Mercantile  	NNP
technical  	JJ
removed  	VBD
hostilities  	NNS
wiped  	VBD
able  	JJ
overlook  	VB
accelerated  	VBD
touched  	VBD
narrow  	JJ
non-precious  	JJ
spiral  	NN
aluminum  	NN
'Profit-Taking  	JJ
Wipe  	VBD
Out  	RP
Early  	JJ
Increase  	NN
altered  	VBN
Adding  	VBG
Paul  	NNP
Volcker  	NNP
stepping  	VBG
succeed  	VB
chairman  	NN
alleviating  	VBG
imports  	NNS
looks  	VBZ
leveled  	VBN
diversified  	VBD
trying  	VBG
choose  	VB
between  	IN
finding  	VBG
choice  	NN
tough  	JJ
wild  	JJ
card  	NN
So  	IN
there\  	NN
pummeled  	VBN
pare  	VB
sidelined  	VBD
kindled  	VBD
Grain  	NNP
single-session  	NN
ever  	RB
ear  	NN
Broad  	NNP
Fueled  	NNP
Rises  	NNP
Expectations  	NNS
confirmation  	NN
marching  	VBG
permeating  	VBG
edginess  	NN
Unless  	IN
we  	PRP
significance  	NN
competition  	NN
collapsed  	VBD
taken  	VBN
unanticipated  	JJ
work  	VB
miracles  	NNS
lines  	NNS
last-minute  	JJ
spree  	NN
Standard  	NNP
Poor  	NNP
500-stock  	JJ
chose  	VBD
explained  	VBD
walking  	VBG
Year  	NNP
force  	NN
descent  	NN
import-sensitive  	JJ
Fuel  	NNP
sagging  	VBG
Bonds  	NNP
Absent  	NNP
discouraged  	VBD
respond  	VB
four-day  	JJ
stretch  	VB
forestalled  	VBD
raced  	VBD
spirited  	JJ
resulted  	VBD
race  	NN
frenzied  	JJ
restructuring  	VBG
variety  	NN
fire  	VB
arbitrage-related  	JJ
Sinai  	NNP
reflect  	VB
developments  	NNS
coming  	JJ
imported  	VBN
handsome  	JJ
future  	NN
rosier  	NN
scored  	VBD
quotas  	NNS
'Many  	JJ
Falters  	NNP
ran  	VBD
refunding  	NN
operation  	NN
Strengthening  	VBG
Yugoslavia  	NNP
members  	NNS
paralleled  	VBN
ca  	MD
sputters  	NNS
affect  	VB
profit-takers  	NNS
excuse  	NN
rate-sensitive  	JJ
barely  	RB
less-than-rousing  	JJ
cheer  	VB
still-sluggish  	JJ
erosion  	NN
ones  	NNS
Oil-industry  	JJ
interest-sensitive  	JJ
fully  	RB
listless  	JJ
hardly  	RB
acknowledging  	VBG
seeing  	VBG
partial  	JJ
good  	JJ
rode  	VBD
coattails  	NNS
mull  	VB
consequences  	NNS
Previous  	JJ
considered  	VBN
'Most  	CC
Slightly  	NNP
Continue  	NNP
overwhelming  	JJ
lured  	VBN
cheered  	VBN
brakes  	NNS
Shift  	NNP
Attention  	NNP
still-lingering  	JJ
food  	NN
Basic-industry  	JJ
bearish  	JJ
predictions  	NNS
rushing  	VBG
available  	JJ
makes  	VBZ
institutional  	JJ
retail  	JJ
dip  	VBP
right  	NN
Connolly  	NNP
crisis  	NN
Ohio  	NNP
precipitated  	VBN
massive  	JJ
weren\'t  	VBZ
concentrated  	VBN
Those  	DT
essentially  	RB
bet  	NN
possible  	JJ
candidates  	NNS
trader  	NN
described  	VBN
simply  	RB
anti-oil  	NN
Prospects  	NNS
air  	NN
fares  	NNS
Finish  	NNP
losing  	VBG
correction  	NN
manager  	NN
Because  	IN
matched  	VBN
weakens  	VBZ
explosively  	RB
Poor\  	NNP
three-day  	JJ
Slight  	NNP
masked  	VBD
capitalization  	NN
blue-chips  	NNS
oil-service  	NN
road  	NN
disappointments  	NNS
attributable  	JJ
stemmed  	VBN
flashes  	NNS
confirm  	VB
spontaneous  	JJ
Both  	CC
favorably  	RB
Helped  	VBN
expanded  	VBN
front  	NN
enabled  	VBD
roll  	VBZ
conjunction  	NN
tremendous  	JJ
belt  	NN
tries  	NNS
minor  	JJ
trading.  	NN
mentioned  	VBD
leadership.  	NN
mount  	VB
extensive  	JJ
coincident  	JJ
increasingly  	RB
portfolio  	NN
seem  	VBP
content  	NN
tepid  	JJ
romance  	NN
exacerbate  	VB
longand  	VB
rates.  	NN
sported  	VBD
bouncing  	VBG
California  	NNP
agreed  	VBD
acquire  	VB
're  	VBP
we\  	JJ
'll  	MD
heavily  	RB
higher-than-average  	JJ
dividends  	NNS
upearly  	JJ
havens  	NNS
Reuters  	NNPS
Europe  	NNP
rallyfaded  	VBN
global  	JJ
corporateearnings  	NNS
doused  	VBD
fuelled  	VBN
LONDON  	NNP
little  	RB
changed  	VBN
banksafter  	NN
countered  	VBN
percent  	NN
*  	JJ
6-month  	JJ
majors  	NNS
subdued  	VBD
St  	NNP
GLOBAL  	NNP
eight-month  	JJ
weighedby  	WRB
shutdownloomed  	VBD
venturedinto  	VBP
risky  	JJ
encouragement  	NN
ventured  	VBD
intorisky  	JJ
Apple  	NNP
anda  	VBP
exporterslifted  	VBN
MARKETS-Upbeat  	NNP
cap  	VBP
Andrew  	NNP
Galbraith  	NNP
fadedafter  	NN
13-month  	JJ
SHANGHAI  	NNP
fizzles  	VBZ
gathers  	NNS
Dudley  	NNP
speech  	NN
Pyongyang  	NNP
eschews  	VBZ
newtests  	NNS
track  	NN
adrop  	NN
MARKETS/  	NNP
MARKETS-Stocks  	NNP
boosts  	VBZ
Updates  	VBZ
lifts  	JJ
Royal  	NNP
Dutch  	NNP
minershurt  	VBN
adamper  	RP
dipped  	VBD
sparkedprofit-taking  	NN
asinvestors  	NNS
holdings  	NNS
hike  	NN
shareswere  	RB
counteracted  	VBN
Brent  	JJ
helpedthe  	VBD
benchmark  	NN
recoup  	VB
bulk  	NN
Greek  	JJ
Euro  	NNP
slips  	NNS
Greece  	NNP
write-down  	JJ
itssteepest  	JJS
monthly  	JJ
fellbelow  	VB
Chair  	NNP
hits  	VBZ
three-week  	JJ
Ukraine  	NNP
simmer  	NN
spur  	VBP
safe-haven  	JJ
intervention  	NN
�  	CC
edges  	NNS
tapering  	VBG
Fridaywhile  	NNP
capping  	VBG
grew  	VBD
cautious  	JJ
paused  	VBD
bookedprofits  	NNS
itsbiggest  	JJ
weekly  	JJ
World  	NNP
bargains  	NNS
diminished  	VBD
June  	NNP
Global  	NNP
weekwhile  	JJ
distillates  	NNS
refinery  	NN
itbecame  	NN
using  	VBG
thedollar  	JJ
Commodities  	NNP
o  	JJ
n  	JJ
F  	NNP
ridayafter  	NN
euro  	NN
zone  	NN
leaders  	NNS
Spanish  	JJ
debtprompted  	VBN
otherdollar-sensitive  	JJ
March  	NNP
than2  	JJ
MARKETS  	NNP
GLOBAL/  	NNP
Strong  	NNP
Jan  	NNP
anear  	VB
16-month  	JJ
anounce  	NN
appetite  	NN
assets  	NNS
majormarkets  	NNS
certain  	JJ
German  	JJ
players  	NNS
partlyrelated  	JJ
riven  	VBN
byposition  	NN
unwinding  	NN
one-week  	JJ
pct  	NN
yieldsand  	VBP
limited  	VBD
lifetime  	JJ
aprofit-taking  	JJ
frenzy  	NN
rating  	NN
downgrades  	NNS
Europebut  	NNP
fizzled  	VBD
ashopes  	NNS
rallies  	NNS
choppytrading  	NN
30percent  	JJ
volumecontributed  	VBD
slidein  	NN
Treasuries  	NNS
spurreda  	VBP
greenback  	NN
falls  	NNS
MARKETS-Absence  	NNP
G20  	NNP
pact  	NN
MSCI  	NNP
ex-Japan  	JJ
28-month  	JJ
MARKETS-Asian  	JJ
slip  	VBP
fights  	NNS
RPT-GLOBAL  	NNP
globally  	RB
better-than-expected  	JJ
spurs  	NNS
vs  	JJ
import  	NN
closes  	NNS
3-month  	JJ
initialsharp  	NN
doubts  	NNS
ending  	VBG
achoppy  	JJ
six-week  	JJ
dataand  	NN
stocksrose  	NN
revives  	VBZ
asstrong  	JJ
globaleconomy  	NN
sapped  	VBD
regained  	VBD
heavyweight  	JJ
bankingissues  	NNS
defensive  	JJ
fallen  	VBN
crudeoil  	NN
longer-dated  	JJ
asweaker  	NN
Dubai  	NNP
debtproblems  	NNS
US  	IN
halts  	NNS
3-day  	JJ
became  	VBD
morecautious  	JJ
scaled  	VBD
consistsof  	VBP
hovered  	VBD
break-even  	NN
eightconsecutive  	JJ
worldwide  	VBP
boostedeconomic  	JJ
brimming  	NN
statement  	NN
gets  	VBZ
beunwinding  	VBG
carry  	NN
upwardpressure  	NN
inverted  	VBN
thecorrelation  	NN
hasbeen  	VBP
offtheir  	RP
14-month  	JJ
versus  	IN
andcrude  	VBP
aneconomic  	JJ
homebuyerswill  	NN
phased  	VBN
investorsscaled  	VBN
rawgoods  	NNS
falter  	VBP
merger  	NN
monthas  	VBZ
inflation-hedge  	JJ
dealers  	NNS
rallyearlier  	NN
STOCKS/LOWS  	NNP
STOCKS  	NNP
SNAPSHOT-S  	NNP
morale  	JJ
widespread  	JJ
doubt  	NN
jumps  	NN
5-1/2  	JJ
shows  	NNS
yet  	RB
hand  	NN
gloomy  	JJ
harm  	VB
fast  	JJ
damp  	VB
STOCKSNEWS  	NNP
NEWS  	NNP
US-Wall  	NNP
dent  	VBP
tops  	VBZ
alsobenefited  	VBD
appeal  	NN
hedge  	NN
potentialinflation  	NN
capped  	VBD
helpedspur  	JJ
afresh  	VB
six-month  	JJ
five-month  	JJ
promptedprofit  	NN
sentiment  	NN
auction  	NN
allays  	VBZ
reportshowing  	VBG
buildon  	VB
incrude  	NN
Better-than-expected  	JJ
JPMorgan  	NNP
dulls  	VBZ
safe-have  	JJ
curbs  	JJ
Citi  	NNP
dampens  	VBZ
unexpectedsurge  	NN
housing  	NN
improveinvestors  	NNS
riskier  	JJR
riskassets  	NNS
slumpingequity  	NN
percentas  	NNS
persistently  	RB
brake  	NN
animpressive  	JJ
glimmer  	NN
rescue  	NN
figures  	VBZ
sessionsas  	NNS
deepening  	VBG
bullion  	NN
goldprices  	NNS
depressgold  	VB
worldwideeconomic  	JJ
currenciesas  	JJ
emerge  	VB
consumers  	NNS
ledinvestors  	NNS
breather  	NN
ascommodity  	JJ
Thursdayafter  	NNP
5-1/2-year  	JJ
roller-coaster  	JJ
dismal  	JJ
beatendown  	JJ
<  	VBP
CLc1  	NNP
>  	NNP
morethan  	RB
stress  	NN
widen  	VB
wildly  	RB
retreatedagainst  	VBD
promptedinvestors  	NNS
lock  	VB
dropped  	VBD
ounceas  	JJ
trend  	NN
oilprices  	NNS
sessionafter  	NN
two-day  	JJ
fouryears  	NNS
fled  	VBD
safer  	VB
wouldaid  	VBD
overits  	NNS
fate  	NN
MARKETS-Dollar  	JJ
bailout  	NN
sag  	VBP
debate  	NN
asresource  	NN
metalsprices  	NNS
multi-month  	JJ
parelosses  	NNS
seven-month  	JJ
dampened  	VBD
pushoil  	NN
erased  	VBD
decliningoil  	NN
appear  	VBP
open  	JJ
theimpact  	NN
overshadowed  	VBD
arecent  	JJ
shore  	VB
infinancial  	JJ
optimismthat  	IN
buffs  	NNS
Silver  	NNP
sank  	VBD
plummetedas  	VBP
incommodities  	NNS
yenas  	JJ
takeprofits  	NNS
quashedthe  	VBD
atwo-year  	JJ
barrellifted  	JJ
theeuro  	NN
preciousmetal  	NN
volume  	NN
oiland  	VBP
analternative  	JJ
exporter  	NN
theoutlook  	VB
soured  	VBN
revision  	NN
steadied  	VBD
ondollar  	JJ
mortgage  	NN
providers  	NNS
capitaladequacy  	NN
spoiled  	VBD
incommodity  	NN
shruggedoff  	NN
offsetmodest  	JJS
ofrecord  	NN
equitymarkets  	NNS
slowed  	VBD
safe-havens  	NNS
andgovernment  	JJ
Chaselifted  	NNP
overshadowedweak  	VBP
stillloomed  	VBD
afterits  	NNS
againstthe  	NN
asan  	NNS
alternative  	JJ
shouldcap  	NN
MARKETS-Global  	JJ
tumbles  	NNS
underpins  	VBZ
theappeal  	NN
stand  	VB
naturalgas  	NN
refined  	VBN
outweigh  	JJ
concernsand  	VBP
Md  	NNP
lowsas  	VBZ
labor  	NN
spike  	NN
theirbuying  	VBG
extends  	NNS
ofcrude  	NN
heights  	NNS
wider  	NN
shifted  	VBN
assetsto  	JJ
Nigeriansupply  	NNP
resume  	VB
followingnegotiations  	NNS
unions  	NNS
strike  	NN
lossin  	NN
thefinancial  	JJ
surges  	NNS
Germany  	NNP
aone-month  	JJ
fed  	VB
aa  	JJ
demandwill  	NN
lastweek  	NN
despitethe  	NN
weakeningdollar  	JJ
stepped  	VBD
andcame  	NN
Nigerian  	JJ
suppliesoutweighed  	VBD
near-  	JJ
weakdollar  	JJ
theground  	NN
agold-backed  	JJ
exchange-traded  	JJ
bullion'srally  	RB
marked  	VBD
sixth  	JJ
highsas  	NN
oilencouraged  	VBD
venture  	NN
energyprices  	NNS
andmaterials  	NNS
poised  	VBD
trades  	NNS
hoversnear  	VBP
butcontinued  	VBN
dollarhelped  	JJ
sought  	VBD
hedgeagainst  	VB
MARKETS-Oil  	NNP
prompts  	VBZ
[  	VBD
HOT-RTRS  	NNP
]  	NNP
Real-time  	NNP
Equity  	NNP
E  	NNP
-listed  	JJ
arise  	NN
makers  	NNS
andcopper  	NN
energycompany  	JJ
inthe  	NN
andcredit  	NN
DOLLAR  	NNP
'S  	POS
STRENGTH  	NNP
ROBS  	NNP
GOLD  	NNP
OF  	NNP
ITS  	NNP
GAINS  	NNP
buoyedby  	NN
ET  	NNP
30Oct2007-Airline  	JJ
US-Airlines  	NNP
lessattractive  	NN
skyrocketing  	JJ
thehighest  	VB
begun  	VBN
27-year  	JJ
Oracle  	NNP
Lehman  	NNP
Brothers  	NNPS
Exxonhelped  	NNP
giant  	NN
one-month  	JJ
recordterritory  	NN
seven-week  	JJ
factory  	NN
extending  	VBG
steepsell-off  	NN
andstronger  	VBP
otherglobal  	JJ
listings  	NNS
domesticnatural  	JJ
storage  	NN
smaller-then-expected  	JJ
draw  	NN
helpedpressure  	VB
complex  	VBP
globalequity  	NN
theoil  	NN
afterclimbing  	VBG
priceshelped  	VBD
reignited  	VBD
economicworries  	NNS
proposed  	JJ
10-  	JJ
12-session  	JJ
unusually  	RB
sharpand  	JJ
therefore  	RB
extreme  	JJ
afteranother  	RB
judged  	VBN
priceson  	NN
colder  	NN
weather  	NN
surprisebuild  	NN
total  	JJ
distillate  	NN
ingasoline  	JJ
barreland  	NN
claims  	NNS
jobless  	JJ
benefits  	NNS
labormarket  	NN
tostand  	VB
pricesoffset  	VBP
astruggling  	VBG
investorsto  	JJ
yellow  	JJ
theirone-week  	JJ
stocksweighed  	VBN
pricesand  	VBP
barrelafter  	NN
abig  	JJ
finishedwith  	NN
Emily  	NNP
Chasan  	NNP
asa  	VBP
brighter  	JJ
picture  	NN
simmers  	NNS
RESF/US  	NNP
XAU=  	NNP
investorsweighed  	JJ
ofthe  	IN
reversing  	VBG
supportfrom  	PDT
worriesabout  	NN
slower  	JJR
Thursdayas  	NNP
ofenergy  	IN
fiveweeks  	NN
helpedspark  	VBD
let  	VB
US-US  	JJ
alate  	NN
draggeddown  	JJ
ofmajor  	JJ
stocksa  	JJ
jitterskept  	IN
marketsthreatened  	VBN
threatened  	VBD
andmining  	VBG
stayed  	VBD
ofinflation  	NN
andmetal  	JJ
com  	NN
EDT  	NNP
RTRS-US  	JJ
-US  	NN
Results  	NNP
diary  	JJ
04Apr2006-US  	JJ
US-Stocks  	NNP
Tuesdayas  	NNP
dollardropped  	VBN
two-month  	JJ
oilcompanies  	NNS
5-year  	JJ
hinders  	NNS
21-month  	JJ
aheadand  	VBP
energyshares  	VBZ
acquisition  	NN
andthe  	VBP
forstocks  	NNS
States  	NNPS
asdeclines  	NNS
pharmaceutical  	JJ
2-a-barrel  	JJ
US-NY  	NNP
11-day  	JJ
17-year  	JJ
stageda  	NN
crimp  	VB
homes  	NNS
limits  	NNS
Bridge  	NNP
users  	NNPS
please  	VBP
click  	VB
nN24604553  	JJ
NY  	NNP
5-week  	JJ
Fridayafter  	NNP
abarrel  	NN
PRICES  	NNP
RISE  	NNP
DESPITE  	NNP
3-year  	JJ
reportshowed  	VBD
aroundfrom  	VBD
oilticked  	VBD
cents  	NNS
concernsgrew  	NN
ratehikes  	NNS
priceslimited  	VBD
thatthe  	JJ
quickly  	RB
reined  	VBD
16-1/4-year  	JJ
highswhile  	NN
equitiesshrug  	VB
thin  	JJ
werecontained  	VBN
toclose  	RB
weighted  	VBN
morerate  	NN
pricesgenerally  	RB
companiesand  	NN
pricesclouded  	VBD
upbeat  	NN
refuge  	NN
firsttime  	NN
anupcoming  	VBG
smallerthan  	JJ
Bernard  	NNP
Orr  	NNP
two-week  	JJ
drewcapital  	NN
manufacturingdata  	NN
hiring  	NN
horizon  	NN
spookedspeculators  	NNS
15-year  	JJ
just  	RB
offsetconcern  	NN
exportrevenues  	NNS
Monday'ssharp  	NNP
speculative  	JJ
four-week  	JJ
speculators  	NNS
one-monthlow  	JJ
storm  	NN
facilities  	NNS
eked  	VBD
COMEX  	NNP
ditched  	VBD
protection  	NN
ofprecious  	JJ
chase  	VB
andbargain-minded  	JJ
industrialcompanies  	NNS
sectorturned  	JJ
leadership  	NN
